11111111111111111111111111111111111111
11111111111111111111111111111111111111
11P00000000000000000000000000000000011
11000000000000000000000000000000000011
11000000000000000000000000000000000011
11000000000000000000000000000000000011
11000000001CCCCC1000011111111000000011
11000000001CCCCC10000CCCCCCC1000000011
110000000011111110000CCCCCCC1000000011
1100000000CCCCCC1000011111111000000011
1100000000CCCCCC100001CCCCCCC000000011
1100000000CCCCCC100001CCCCCCC000000011
1100000000CCCCCC1000011111111000000011
11000000000000000000000000000000000011
11000000000000000000000000000000000011
11000000000000000000000000000000000011
11000000000000000000000000000000000011
11000000000000000000000000000000000E11
11111111111111111111111111111111111111
11111111111111111111111111111111111111