1111111111111111
1C000000C0000001
1000011001111001
10001010000C1001
10C11110011110C1
10000C10010E0001
10000010C1111001
10000P00000000C1
1111111111111111