0000000000000
00010000000C0
0000011111000
0P0011E000000
0000000000000